20 20
0 1
19 18

#P###################
#.......#.#.......#.#
###.#####.#.###.###.#
#.....#.....#...#...#
#.#.#.###.#######.#.#
#.#.#.....#...#.#.#.#
#.#.#.###.###.#.###.#
#.#.#.#...#.........#
###.###.#######.###.#
#...#.........#.#...#
#.#######.#.#.#.#####
#.....#.#.#.#...#...#
#####.#.#.#.#######.#
#.....#...#.#...#.#.#
#.#.#.#.#######.#.#.#
#.#.#.#.#.#.....#.#.#
#.###.#.#.###.#.#.#.#
#...#.#.#.....#...#.#
#.#######.#####.###.#
#...........#.......#
###################F#
